111111111111111
1P000C00C0000E1
1000000e0000001
111111111111111