111111111111111
1P00000e00001E1
100000000000001
10e0000C0000e01
111111111111111