11111111111
1P00e100001
10101101101
10100001001
10111111011
10001CC10E1
1e101C01111
11101101111
10001e00001
10111111101
10000000001
11111111111