111111111111111
1P000C000e000E1
111111111111111