11111111
1C0000E1
11100111
10000001
10100001
1C10P001
11111111