11111111
10000001
100C0001
10000001
10000E01
1P000001
11111111