111111111111111
1P000C00C0000E1
100000000000001
111111111111111