11111111111
1PEC0100001
10100001001
10100001001
10111111001
10001001001
10001001111
11101000001
10001000001
10111111101
10000000001
11111111111